zsv: ere uxw
uqg: rip oau bpq jhi
bjo: wpp igo you
wki: gvz gmn fkf
qdg: dke mxk
xbe: hwc oby xup svd yif
jpn: zuu fkn
lrc: dmp swb utp
vfe: fpu
olg: azf
mgp: xey
jic: svd xup hwc oby yif
jur: kte
lox: mxv wse
imp: zsv ihp adn
cbc: src
wbr: dmp swb ubo dig utp
fzy: fwb
rud: jpn cwt qsh
hgg: fph buf qmb myw
pkf: wpp urc igo vxk
mjx: qwl gyp krh
vev: gqd qup
cmr: sfg bwu mhw pch
myf: olg qxh dac
wse: kcs pzx qkr
cyy: out
rog: ftz ejb
yif: acx mkr
mmp: gjw vgs exx
kpp: yfa ftz sag
axw: jvk jwp ryu iin
hjb: out
wue: pns jda
xcq: ezj
ahv: hdz lgj
psu: him nwk
jvk: zxr evs
tem: out
ebc: out
vxw: ifh tqz
hna: syz fnj rvy jxu
dng: hkb asj nsd
mut: gvy jur nnq
yxt: gyp krh
lpw: uiu bbt
lhf: mpk gnt pto vla
djy: ryj kuf
oya: yfa
ffj: lkd nan
wxg: ahv njr col ugx
qjo: wdp zor
sny: him
xcp: out
vgg: avy
iyq: jpn cwt
mhw: nzx uoa smu nnb
uxw: jbg ysf dvc
zbh: mgl psf apy
lda: zrc vaz hgg
ezj: ubu
hmw: oke
gvy: dal hwp kte
tno: fkf
vdd: myf
hqq: yve zbx
xgp: yxc
bsb: ysf jbg
pto: jwr hka rud gfl ydt soy zgd
fie: rpq
nwo: iuu vla pto mpk gnt
ujs: zor yve nzs
qdz: lmo cnx
dda: cve kvh tjk
fqk: xib jqm
cve: ysf ivs
bwi: osp dye
ohe: gsb
rcw: xfe hgq yjn
aut: bjf zno
dac: xqn zug azf
gtn: vxk wpp urc
wiy: mxk fqk xwh
fyf: hav fzy qim mjx neg syq nfv bbi
xbu: qjo ujs hqq
jhe: out
kst: ftz ejb
uar: ztj eso fkx cvu
iuu: zgd vle gfl hhm fbb iyq tso hka hns wie soy ydt lox gal rud
yfg: pxl zph amk zmr vlq mel dxe kmh smj sny zsg ujc psu mxs ghv axw ppx qys wqg beg
dcz: xvi
ctn: fph buf
ups: jwo yfg
srm: ujd bsk
awg: xup hwc yif
ftu: kfo
sog: iuu vla gnt mpk
yrg: iuu vla
ypt: fkx diz eso cvu
oan: jxu rvy bzq syz
nip: out
xxd: lda vha
bnj: zno bjf
fap: ejb sag ftz yfa
xph: ezj
ske: lep fie
xvp: xuy kpn pkf
yie: sxv lmr
you: ftu cig mut mgp cog iou igb rzz qdz rhg lfb geh mht
wxx: bjf xku nvq
rhg: lmo uar
epy: vlu rpv
acx: gtn
vvr: fuv drs
vwd: imp ztu bui
nzs: wvb ixv
adn: uxw bsb zas
bge: nsd asj hkb
mpk: hhm gfl vle zgd tso fbb hka hdj soy ydt wie hns iyu gal lox jwr rud
sim: ery qdg
bwu: xty smu nnb uoa
yap: xvp fly jck
wzz: igo you wpp
xku: wbv
eyb: zmh
wpp: rnx igb kdm rzz iqx jxm geh cnp fhw cig ftu iou mgp lnn
gmn: qup
tuf: iik
qmb: vxk you urc igo
hwp: plr
fdv: imh yra usz rog
aaz: wue
yky: ooz
wha: rpv myf
vwb: vxk wpp you igo
fjw: utp dig dmp
lzd: sxv lmr cfk
igb: giq gvy nnq
kes: jae ryj lip
gwo: xcq xph
wqg: nwk cmr nhl
sfg: nnb xty uoa nzx
dnn: tdk bbt uiu
lmx: xmk yfg jwo
lmk: out
gfl: pnr dnn fzs lpw
iin: zxr zyg
wbv: nwo uio dye osp
uiy: ooz oya drs
cnn: nos qbo
yxc: out
uhs: ifh wpq
svd: zbs
cog: gvy giq fkl jur
ugx: dda lgj hdz
ujg: jbg ivs dvc
iue: fnj jxu bzq syz
wgt: ejb
hwc: mkr ufh acx zbs
ioz: ymz hmw
ryj: ohe xgp
brd: xzk xyk lod
xup: acx mkr zbs
tnx: tqz wpq
ysf: rgw joz rme epy awg jic fwm dcz kzx trk ltg xbe ywo hke vdd
lnn: tbv vvp wue
jta: jhe luz yxc
dtf: vha src lda guw
jhi: lod xou xzk
kuf: jta xgp
nos: tem urr djb lgi
vlu: qxh
psx: yve zbx nzs
vvp: pns
ghv: bsj vgg
rzz: ypt lmo uar hoj
wwh: iuu gnt
ftz: gnr sou hnz oan evv sim tov hna
rjf: xmk yfg
nvq: wbv
cnx: cvu fkx
exh: syz rvy
yuj: xku
zor: ixv och zqq
rnx: svx cce kfo
suw: mjc ruh wlm hwx edo
rgw: myf
nnq: kte hwp dal
hdj: thi
beg: him cmr nhl
ryu: evs zxr
bjf: wbv bwi tbj
wmj: vxk urc igo
vcu: out
gip: ydj
evs: azc
kcs: xit wgt
kdh: sag
cij: lud
amk: bnj yuj wxx yyp aut
syg: yfg xmk
isd: fpu jrp gip
dke: jqm xib tis
hdr: xbl vwd
zmh: ruh
oke: ugf
wlm: aou
kba: xfe
edo: aou
vcz: plr ske dvf
ltg: xxd lgb dtf
ery: fqk mxk xwh
pmp: yap
hgq: nan wdv lkd
cvu: wpj cnn
soy: qvv nui
xvi: pmz
dla: urc wpp
whp: znr iik qap
wvx: qbo
fht: xuk
lfb: kfo svx ngm cce
lgb: lda guw vha src
tjf: acl tfw gwo xom
twj: dlc wki tno
kpe: syx
acl: xph fht xmr xcq pmz
bui: qoi
fkf: gqd rjf
kvh: jbg ivs
pjg: lmx ujd bsk
fwn: psf mgl apy
gjw: mef srm
bsk: jwo
jwo: ppx sny wqg ggf zph amk ujc dxe vlq
aou: xmk
xib: ujg dxb tky
asj: aun zmh
sag: vyu hna wxg iue seo cbb hdr yzm uqg
lod: otq gia sui
czt: iuu vla mpk
fhw: tbv vvp
xzk: sui
htm: qae
ggf: bsj vgg nwc mhl
xau: sxv kpp cfk
bbi: hqq adh qjo psx
jhd: dvc jbg ysf
joz: yif xup hwc oby
mxk: tis xib
svr: zaw ygp gie fyf
mfr: tdk uiu
ruh: ups
luz: out
mgl: yrg
col: lgj dda
qim: meu ohu uqf mmp cxo
zpg: kpe
osp: gnt iuu
azc: vla pto gnt mpk
mxs: jwp ryu owz
pgr: gnt vla iuu pto
fzs: tdk bbt
geh: ypt
qkr: xit kst kdh
tlc: imp ztu
hwx: hex ups
vyu: tlc xbl vwd
kpn: you urc igo wpp
vlq: fwn xem zbh sse
ywo: lgb dtf cbc
trk: xxd dtf
tso: dnn mfr lpw fzs
xom: xmr fht xph
uqf: vgs exx
gyp: wbr fjw
mef: bsk lmx
dxb: jbg ysf
hnz: oau jhi
zxr: kjw grn azc
vou: gia sui
neg: rcw
zsg: nwc mhl opm vgg
rpv: iva
ftl: ivg ioz
dpy: iik eit znr
him: pch bwu mhw sfg
svx: mod djy dqp
yra: yfa
zqq: jwo yfg
zaw: cub avf hav fzy pwt dng nhx nam mjx myp tii wxo xbu nfv tes bbi ieq bge
nwk: bwu ieg
xwh: zip
xqn: you igo urc vxk
cwt: edp
efw: kcs pzx
hoj: eso
jwr: dpy
dxs: dgv vfe zpg isd
rki: jhe lmk luz
seo: njr col uuv ugx
wno: nip ydj
qsh: zuu
eso: cnn kzd wvx cij
avy: lhf pgr fmk czt
buf: urc you igo wpp
drs: ejb sag
tio: vxk igo you wpp
guw: hgg ctn zrc vaz
dye: vla
hyv: kpp cfk lmr
xuk: vwb wmj
adh: wdp nzs zor
ere: jbg
gwp: rog usz yra imh ubb
cup: out
evv: xbl
xem: fft
hdz: cve tjk
dlc: gvz xww gmn fkf
gsb: out
lmr: yfa ejb
syz: htm
mkr: tio gtn wzz
ion: suw zmh
lip: rki
yzz: ysf ivs
tbv: vox
nnb: mpk pto iuu
zph: fwn zbh xem
kzd: qbo
yjn: fyn vew lkd wdv
wdp: ixv och
tov: fhi ery qdg
zyg: grn
jwp: zxr
ooz: sag ftz
cge: vuj fap
zbs: tio
bvo: ftz yfa ejb
qxh: azf
fkl: vcz kte hwp
mhl: rqg zhy
psf: wwh afw yrg qtt
qwl: lrc wbr fjw
ivg: ymz hmw yap
fbb: mfr fzs
jck: pkf hto kpn ugf
bpq: xyk
zgz: kcs qkr
ori: ffj
cub: oyv fwb
iyu: dpy tuf
zgd: whp
tfw: xph fht pmz xmr
wpj: nos lud qbo
jda: tnx
cfk: ejb
oby: mkr acx ufh zbs
igo: mut lnn aaz mgp fhw ftu kdm rzz igb geh lfb mht qdz jxm rhg
lgi: out
yve: syg och wvb ixv
src: hgg
hkb: zmh aun suw
ppx: wxx aut yyp yuj bnj
owz: zxr
thi: eit znr
tjk: dvc ysf jbg ivs
njr: dda lgj hdz mmf
ejb: wxg seo uqg sou exh vyu
imh: ftz yfa ejb sag
kjw: gnt
ieq: kba ori rcw
kmn: tlc
bex: dvc ivs
tnb: yzz lki
cig: ngm
tky: jbg ysf ivs dvc
ydj: out
hjs: out
gnt: tso iyq sca hdj zgd gfl hhm jwr ydt iyu lox
vaz: qmb dla
rip: vou lod xou
jqm: tky dxb
tes: ujs
qtt: gnt mpk iuu pto
fmk: mpk gnt vla pto
afw: gnt pto
irp: out
yaz: fkn
ieg: nzx smu nnb xty
iqx: fkl
xxu: bsk
fpu: cup ydj hjs
fwb: tno
jrp: hjs syx cup nip
ujd: yfg jwo
qae: ivs ysf jbg
otq: fcn bex jhd
qys: opm vgg
fyn: jwo xmk
krh: fjw lrc
zmr: zbh xem sse
meu: exx vgs gjw
zug: wpp
nam: hqq adh psx qjo
pch: xty nnb smu uoa nzx
diz: kzd wvx cij wpj
fly: hto pkf xuy kpn ugf
tee: out
zrc: fph dla qmb myw
kdm: tbv usy vvp
gie: myp nam dio nhx pwt lvl hav cub avf bge neg ieq tes bbi nfv xbu tii yxt qim
nhl: mhw sfg
xee: ako fap
urr: out
cce: mod dqp
ubu: igo wpp
edp: fdv ycx
fcn: dvc ysf ivs
myw: igo urc
fhi: xwh dke
uoa: iuu vla pto gnt mpk
pnr: bbt
nhx: nsd ion eyb hkb
meb: qxh iva olg
zas: dvc ivs
vox: vxw
ydt: yaz qsh
zcl: oya drs ooz
gnr: njr ahv col uuv ugx
hzt: zpg
fwm: oby svd xup yif
vle: cge
sca: nui xee
pns: uhs tnx
hex: jwo xmk yfg
znr: mub vvr zcl
sou: wiy
sui: fcn bex
ubb: sag yfa ftz
uuv: mmf
iva: xqn zug
ycx: rog yra imh ubb
tqz: cyy ebc
iik: yky vvr mub zcl
myp: fwb twj
xmk: pxl zmr mel smj zsg ujc psu ghv axw ppx wqg qys ggf beg
fuv: ftz yfa ejb sag
qia: ngm svx
mel: yyp yuj
grn: mpk gnt pto iuu
ngm: kes
zuu: ycx fdv
ygp: nfv bbi tes ieq neg bge syq yxt tii wxo xbu pwt dng dio nhx lvl nam mjx myp cub hav
nwc: zhy avy
ztu: adn zsv
djb: out
dqp: kuf lip jae
lmo: eso diz ztj
fkx: kzd wvx wpj cnn
yzm: brd oau
uio: gnt mpk
mgc: vfe
els: ako fap
vla: rud jwr lox iyu soy hns wie hdj tso sca fbb gfl hhm vle
yze: gvz xww vev gmn fkf
rqg: fmk sog pgr lhf
mxv: pzx kcs
oyv: wki yze tno
cew: gwo tfw acl
hke: pmp ivg
plr: fie
ixv: jwo
pzx: kst kdh bvo wgt
lkd: yfg
xty: mpk pto iuu
sxv: yfa sag
lvl: cxo mmp meu
jlb: bzq syz fnj rvy
ako: yfa ftz sag
yfa: jvm jlb hnz uqg kmn yzm gnr tov exh evv
jxu: htm
gqd: yfg
fft: yrg qtt afw wwh
pxl: sse xem zbh
ubo: yfg
hav: hkb nsd
opm: rqg avy
mht: nnq gvy
lgj: kvh cve tjk
lud: djb hjb lgi
kmh: mhl bsj opm vgg
pjj: hzt mgc dxs sdf
yyp: bjf nvq
ujc: him nwk
xit: ejb
usz: sag
jxm: pjj rzk xey
ymz: oke jck fly xvp
syq: oyv
hns: zgz wse mxv efw
iou: pjj rzk
avf: oyv
hhm: dpy thi whp
wpq: xcp
aay: ubu bjo
qap: zcl yky vvr uiy
dgv: fpu jrp wno gip
jjt: yzz lki
uyx: hmw
sse: apy psf fft
nzx: vla mpk
nfv: ohu mmp uqf
mjc: ups hex aou
gvz: rjf gqd
apy: wwh qtt afw
swb: xmk jwo
cbb: rip
dxe: iin ryu jvk
usy: pns vox
bzq: tnb
tii: ori kba
cxo: exx gjw
jvm: bpq oau rip jhi
tbj: nwo dye
azf: wpp igo urc vxk
rvy: htm tnb
ifh: xcp cyy
vgs: mef xxu pjg
lki: dvc jbg
wie: yaz qsh
aun: mjc ruh hwx edo
nui: ako
xey: dxs hzt mgc
vha: zrc hgg
vxk: cnp qia cog iou lnn mut cig ftu rzz kdm rnx mht lfb iqx rhg jxm
xou: sui
oau: xyk lod vou xzk xou
dig: xmk jwo
smu: gnt pto
tis: dxb ujg
bbt: yie hyv xau lzd
cnp: hoj cnx ypt
pmz: xuk aay
dvf: xrf
sdf: isd vfe dgv
xfe: nan wdv
xyk: otq
giq: hwp vcz
och: jwo
ohu: vgs gjw
wxo: hqq adh qjo psx
qbo: djb
lep: tee
qup: xmk yfg jwo
ihp: ere zas
ufh: wzz
rpq: out
zip: ujg
nsd: suw aun
mmf: kvh cve
xmr: ezj xuk aay
uiu: xau yie
kzx: meb
tdk: xau hyv lzd
vew: yfg xmk
smj: iin owz jwp jvk
bsj: rqg zhy
urc: lfb iou jxm qdz rhg fhw rzz qia
hto: urc wpp
lwz: ujd
ugf: you urc vxk
mub: oya drs fuv ooz
dal: dvf ulf ske
xuy: vxk wpp urc you
xbl: imp
dvc: kzx trk ftl tjf xbe vdd ltg joz rgw rme awg jic fwm dcz
zhy: pgr lhf fmk
rzk: sdf
fph: urc
syx: out
wdv: yfg
gia: jhd fcn
jae: jta rki ohe
kte: plr ulf ske
zbx: wvb ixv syg zqq
mod: ryj
zno: tbj bwi wbv
ztj: cnn wpj cij wvx
gal: zgz efw
exx: lwz pjg
fnj: jjt
ulf: lep
pwt: eyb
ivs: ltg ywo xbe hke wha tjf ftl cew trk kzx dcz fwm jic awg rme epy rgw joz
nan: jwo
vuj: sag ejb yfa
wvb: jwo xmk yfg
dmp: jwo xmk
kfo: mod djy dqp
eit: vvr
xrf: tee irp rpq vcu
qvv: fap ako vuj
rme: ioz uyx
dio: krh
jbg: ftl epy cew trk rgw joz fwm dcz ltg ywo vdd
utp: jwo
hka: qvv els cge
xww: qup
qoi: uxw
fkn: ycx gwp
